0 0-EV-1
1 7-DW-11
2 7-CR-1
3 7-CR-1
4 7-CR-1
5 7-CR-1
6 7-CR-1
7 7-DW-3
8 7-PT-1
9 7-PT-1
10 7-PT-1
11 7-CR-1
12 7-CR-1
13 7-CR-1
14 7-CR-1
15 7-CR-1
16 7-CR-1
17 7-DW-10
18 7-DW-4
19 7-CR-1
20 7-CR-1
21 7-WS-1
22 7-WS-1
23 7-WS-1
24 7-WS-1
25 7-WS-1
26 7-WS-1
27 7-WS-1
28 7-WS-1
29 7-WS-1
30 7-WS-1
31 7-WS-1
32 7-CR-1
33 7-DW-5
34 7-CR-1
35 7-PRO-1
36 7-CR-1
37 7-PRO-1
38 7-PRO-1
39 7-CR-1
40 7-CR-1
41 7-DW-6
42 7-CR-1
43 7-CR-1
44 7-CR-1
45 7-DW-9
46 7-CR-1
47 7-CR-1
48 7-RL-2
49 7-RL-2
50 7-RL-2
51 7-RL-2
52 7-RL-2
53 7-RL-2
54 7-RL-2
55 7-RL-2
56 7-RL-2
57 7-RL-2
58 7-RL-2
59 7-RL-2
60 7-RL-2
61 7-RL-2
62 7-RL-2
63 7-RL-2
64 7-CR-1
65 7-CR-1
66 7-DW-7
67 7-CR-1
68 7-CR-1
69 7-CR-1
70 7-CR-1
71 7-CR-1
72 7-DW-8
73 7-CR-1
74 7-PRO-2
75 7-CR-1
76 7-PRO-2
77 7-PRO-2
78 7-PRO-2
79 7-PRO-2
80 7-PRO-2
81 7-PRO-2
82 7-PRO-2
83 7-PRO-2
84 7-PRO-2
85 7-PRO-2
86 7-PRO-2
87 7-PRO-2
88 7-1PO-2
89 7-1PO-2
90 7-1PO-2
91 7-1PO-2
92 7-1PO-2
93 7-1PO-2
94 7-1PO-2
95 7-1PO-2
96 7-1PO-2
97 7-1PO-1
98 7-1PO-1
99 7-1PO-1
100 7-1PO-1
101 7-1PO-1
102 7-1PO-1
103 7-1PO-1
104 7-PRO-1
105 7-PRO-1
106 7-PRO-1
107 7-PRO-1
108 7-PRO-1
109 7-PRO-1
110 7-PRO-1
111 7-PRO-1
112 7-PRO-1
113 7-PRO-1
114 7-PRO-1
115 7-PRO-1
116 7-2PO-1
117 7-2PO-1
118 7-2PO-1
119 7-2PO-1
120 7-2PO-1
121 7-2PO-1
122 7-2PO-1
123 7-2PO-1
124 7-2PO-1
125 7-2PO-1
126 7-LR-1
127 7-LR-1
128 7-LR-1
129 7-LR-1
130 7-LR-1
131 7-LR-1
132 7-LR-1
133 7-LR-1
134 7-LR-1
135 7-LR-1
136 7-LR-1
137 7-LR-1
138 7-LR-1
139 7-LR-1
140 7-LR-1
141 7-LR-1
142 7-LR-1
143 7-LR-1
144 7-LR-1
145 7-LR-1
146 7-DW-2
147 7-PT-1
148 7-PT-1
149 7-PT-1
150 7-PT-1
151 7-PT-1
152 7-PT-1
153 7-PT-1
154 7-PT-1
155 7-DW-1
156 7-PT-1
157 7-PT-1
158 7-PT-1
159 7-RL-1
160 7-RL-1
161 7-RL-1
162 7-RL-1
163 7-RL-1
164 7-RL-1
165 7-RL-1
166 7-RL-1
167 7-RL-1
168 7-RL-1
169 7-RL-1
170 7-RL-1
171 7-RL-1
172 7-RL-1
173 7-RL-1
174 7-RL-1
175 7-RL-1
176 7-RL-1
177 7-PT-1
178 7-PT-1
179 7-PT-1
180 7-PT-1
181 7-DW-12
182 7-AT-1
183 7-AT-1
184 7-AT-1
185 7-AT-1
186 7-AT-1
187 7-BA-1
188 7-BA-1
189 7-BA-1
190 7-BA-1
